NO ./textures/backrooms_wall.xpm
SO ./textures/backrooms_wall.xpm
WE ./textures/backrooms_wall.xpm
EA ./textures/backrooms_wall.xpm

F 142,132,94
C 218,203,155

11111111111111111111111111111
10000000000000100000000000001
10111111011111101111110111111
10100000000000000000000000001
10101010101010101010101010101
10100000000000000000000000001
10101010101010101010101010101
1000000000000W000000000000001
10101010101010101010101010101
10000000000000000000000000001
10101010101010101010101010101
11111111111111111111111111111
