NO ./textures/severance/wall.xpm
SO ./textures/severance/wall.xpm
WE ./textures/severance/wall.xpm
EA ./textures/severance/wall.xpm

F 118,120,108
C 196,196,192

1111111111111111111111111
1000000000000000000000001
1000000000000000000000001
1000000011111111100000001
1000000010000000100000001
1000000010100100100000001
1001111010100100100000001
1000000010100100100000001
1000000010000000100000001
1001111010000000100000001
1000000010000000100000001
1000000011110111100000001
1000000000000000000000001
10N0000000000000000000001
1000000000000000000000001
1111111111111111111111111
