NO ./textures/test/north.xpm
SO ./textures/test/south.xpm
WE ./textures/test/west.xpm
EA ./textures/test/east.xpm

F 100,100,0
C 204,229,255

11111111
100N0101 111
10101001 101
10000001 111
11111111
